word: suggested words
AAAAHHHH: []
AAAAHHHHH: []
AAAggghh: ['Arghh']
ABoardddDDDDDD: []
AHHHHH: []
AHHHHHHHHHHHH: []
AWHOO: ['YAHOO', 'ACHOO']
Aaaaaa: []
Aaaaaaaaa: []
Aaaaaaaaggghhh: []
Aaaaaah: ['Aah']
Aaaaahhh: []
Aahh: ['Aah', 'Ayah']
Aahhhh: ['shhh', 'Shhh']
Abcya: ['Arby', 'Abscissa']
Achmed: ['Ahmed', 'Ached']
Acktavio: ['Octavio', 'Octavo']
Aesopius: ["Aesop's", 'Aesop']
Aesopus: ['Aesop-us', 'Aesop us']
Ahhhhh: ['shhh', 'Shhh']
Ahhhhhh: []
Ahhhhhhhhh: []
Aipom: ['Aim', 'Aplomb']
Alacosta: ['Acosta', 'Almost']
Aligator: ['Alligator', 'Ali-gator']
Aliosaurus: ['Spinosaurus', "Alisa's"]
Alladin: ['Aladdin', 'Allan']
Alliey: ['Allie', 'Alley']
AlllLLLLLLL: []
Almack: ['Alma-ck', 'Alma ck']
Alphaviva: ['Alpha-viva', 'Alpha viva']
Altoid: ['Altoids', 'Alto-id']
Anasta: ['Anastasia', 'Canasta']
Andeg: ['An-deg', 'An deg']
Antartic: ['Antarctic', 'Antarctica']
Aooo: ['Achoo', 'hoopoe']
Aooooooo: []
Apatasaurus: ['Apatosaurus', 'Styracosaurus']
Aphabet: ['Alphabet', 'Abet']
Archeology: ['Archaeology', "Archaeology's"]
Arghhh: ['Arghh', 'Argh']
Aristocats: ['Aristocrats', "Aristocrat's"]
Arithometer: ['Audiometer', 'Arithmetic']
Armadillas: ['Armadillos', "Armadillo's"]
Aronoff: ['Aron-off', 'Aron off']
Arrgh: ['Argh', 'Arghh']
Arrrrghh: ['Arghh', 'Argh']
Arrrrrrrrrrrrrrrr: []
Artest: ['Artiest', 'Art-est']
Asheville: ['Nashville', 'Deville']
Asmuth: ['Bismuth', 'Azimuth']
Atitlan: ['Aztlan', 'Antillean']
Atmega: ['At-mega', 'At mega']
Attice: ['Attic', 'Attire']
Augh: ['Aught', 'ugh']
Austraila: ['Australia', 'Austria']
Auuuuuugggghh: []
Awsome: ['Awesome', 'Aw-some']
Awww: ['Aw']
Awwww: []
BAAAA: ['BAA-AA', 'BAA AA']
BBBBUUUURRRRPPPP: []
BBVA: ['BB-VA', 'BB VA']
BERNARDS: ["BERNARD'S", 'BERNARD']
BIGUY: ['BI-GUY', 'BI GUY']
BIMIMBOB: ['BIMBO', 'BIMBOS']
BMXing: ['Bing', 'Bring']
BOLOGNAISES: ["BOLOGNA'S", 'BOLLIXES']
BOWSER: ['BROWSER', 'BOWS-ER']
BRAINFREEZE: ['BRAIN-FREEZE', 'BRAIN FREEZE']
BUZZZZZZZ: ['BUZZ']
Baaa: ['Baa', 'Baas']
Baaaaaaaa: []
Backyardigans: ['Backyards', "Backyard's"]
Bact: ['Bract', 'Ba-ct']
Bactrains: ['Bactrian', 'Quatrains']
Bajie: ['Bhaji', 'Basie']
Bakugan: ['Balkan', 'Bargain']
Bakugans: ['Balkans', 'Bargains']
Bamm: ['Ba-mm', 'Ba mm']
BandZ: ['Band', 'Bandy']
Bandz: ['Ban-dz', 'Ban dz']
Bankotsu: ['Banknotes', "Banknote's"]
Banteay: ['Barney', 'Banter']
Bazen: ['Brazen', 'Ba-zen']
Bazzy: ['Jazzy', 'Bzz']
Beanz: ['Benz', 'Bean']
Becuase: ['Because', 'Recuse']
Bedknobs: ['Bed-knobs', 'Bed knobs']
Beeker: ['Baedeker', 'Seeker']
Beezus: ['Bees', 'Breezes']
Beiber: ['Briber', 'Berber']
Belevarde: ['Boulevard', 'Boulevards']
Bellys: ["Belly's", 'Belly']
Berings: ["Bering's", 'Bearings']
Berrr: ['Berry', 'Berra']
Beyblades: ['Bey-blades', 'Bey blades']
Bibimbab: ['Bibimbap', 'Simba']
Bibliographhy: ['Bibliography', "Bibliography's"]
Bieber: ['Briber', 'Berber']
BigW: ['Big', 'Brig']
Birchbark: ['Birch-bark', 'Birch bark']
Biv: ['Bi', 'Xiv']
Bleah: ['Bleach', 'Blah']
Blessan: ['Bless-an', 'Bless an']
Bloaty: ['Bloat', 'Bloats']
Blowfish: ['Blow-fish', 'Blow fish']
Blueland: ['Blue-land', 'Blue land']
Bluetoe: ['Blue-toe', 'Blue toe']
BoJo: ['Boo', 'Bozo']
Boanerges: ['Borges', 'Boners']
Bobsin: ['Bobs-in', 'Bobs in']
Bokuem: ['Hokum', 'Bunkum']
Boomwhackers: ['Boom-whackers', 'Boom whackers']
Borchert: ['Botcher', 'Borscht']
BoxBall: ['Box-Ball', 'Box Ball']
Brainpop: ['Brain-pop', 'Brain pop']
Braith: ['Wraith', 'Breath']
Brendamoor: ['Brenda-moor', 'Brenda moor']
Bridgeview: ['Bridge-view', 'Bridge view']
Britanic: ['Britannic', 'Britannica']
Brrrrr: ['Brr', 'Brrring']
Brusha: ['Brush', 'rush']
Brysi: ['Brays', "Bray's"]
Buddah: ['Buddha', 'Judah']
Buey: ['Bluey', 'Buy']
Buhbuhbuh: []
Buloni: ['Bullion', 'Bulgogi']
Bundt: ['Bunt', 'Burnt']
Buneary: ['Boundary', 'Burner']
Bunnings: ['Buntings', "Running's"]
Burgoune: ['Burgoyne', 'Burgeoned']
Butterflys: ["Butterfly's", 'Butterfly']
Buttertubs: ['Butter-tubs', 'Butter tubs']
Buzzie: ['Buzzes', 'Buzzer']
Byheem: ['Belem', 'hee']
Bynums: ['Bums', 'Benumbs']
CATHEDRA: ['CATHEDRAL', 'THEODORA']
CESARIO: ['CESAR-IO', 'CESAR IO']
CHUNGYCHEON: []
CIML: ['CI-ML', 'CI ML']
COCKADOODLEDOO: ['CANOODLED', 'DOODLED']
Calamvale: ['Claimable', 'Calmly']
Califonia: ['California', 'Californias']
Callay: ['Cal-lay', 'Cal lay']
Callidus: ['Callus', 'Callous']
Callooh: ['Call-ooh', 'Call ooh']
Cameleon: ['Chameleon', 'Camel-eon']
Camodo: ['Condo', 'Cameo']
Candylicious: ['Candidacies', "Candice's"]
Cannonbolt: ['Cannon-bolt', 'Cannon bolt']
Canticlarus: ['Canticles', 'Chanticleers']
Canucks: ["Zanuck's", 'Cranks']
Capannari: ['Japanning', 'Canary']
Captin: ['Caption', 'Captain']
Carmealo: ['Carmelo', "Carmelo's"]
Carnail: ['Car-nail', 'Car nail']
Cartman: ['Cart-man', 'Cart man']
Caseys: ["Casey's", 'Casey']
Catamounts: ['Cat-amounts', 'Cat amounts']
Catheduals: ['Cathedrals', "Cathedral's"]
Catoons: ['Cartoons', "Cartoon's"]
Cazair: ['Czar', 'Crazier']
Centi: ['Cent', 'Centime']
Chairmouse: ['Chair-mouse', 'Chair mouse']
Chapstick: ['Chaps-tick', 'Chaps tick']
Chchchch: ['cha-cha-cha', 'Cha-cha-cha']
Cheeseheads: ['Cheese-heads', 'Cheese heads']
Chekeria: ['Cheerio', 'Checker']
Cheonmseongdae: []
Chewbaca: ['Chibcha', 'Cherubic']
Chichen: ['Chic-hen', 'Chic hen']
Chieftan: ['Chieftain', 'Chief-tan']
Chnnang: ['Chang', 'Chinning']
Choclate: ['Chocolate', 'Choc-late']
Choos: ['Choosy', 'Choose']
Chritmas: ['Christmas', "Christmas's"]
Chubchub: ['Chub-chub', 'Chub chub']
Chuga: ['Chugga', 'Chug']
CiCi: ['Ci-Ci', 'Ci Ci']
Cicular: ['Circular', 'Circulars']
Ciliia: ['Cilia', 'Clii']
Cinemark: ['Cine-mark', 'Cine mark']
Citi: ['Ci-ti', 'Ci ti']
Claremmont: ['Clement', 'Claimant']
Clawd: ['Clawed', 'Claw']
Clawdeen: ['Coleen', 'Claude']
Claypans: ['Clay-pans', 'Clay pans']
Cocoo: ['Cocoon', 'Co-coo']
Colorflies: ['Color-flies', 'Color flies']
Colwin: ['Col-win', 'Col win']
Comenius: ['Comes', 'Comments']
Compounce: ['Comp-ounce', 'Comp ounce']
Conersation: ['Conversation', 'Conservation']
Coookie: ['Cookie', 'Cookies']
Copperbottom: ['Copper-bottom', 'Copper bottom']
Coqu: ['Coup', 'Toque']
Coquus: ['Coups', 'Conquers']
Cosley: ['Coley', 'Mosley']
Crittercams: ['Critter-cams', 'Critter cams']
Crocita: ['Crochet', 'Conceit']
Crotona: ['Crouton', 'Croon']
Cruisin: ['Cruising', 'Cuisine']
Cuddyer: ['Cud-dyer', 'Cud dyer']
Curstien: ['Curtain', 'Cursing']
Curtie: ['Cur-tie', 'Cur tie']
Curtins: ['Curtains', 'Curt-ins']
Cutthrout: ['Cutthroat', 'Cutthroats']
Cuttie: ['Cut-tie', 'Cut tie']
D'Undranae: []
D'oh: ['Doth', 'Dosh']
DAWGS: ['DAGS', 'DRAWS']
DENIQUE: ['UNIQUE', 'DENUDE']
DKHarry: ['Harry', 'Tarry']
DSi: ['Si', 'Di']
Daa: ['Data', 'Dana']
Daaaay: ['Day', 'Dray']
Dadddy: ['Daddy', "Daddy's"]
Dalmation: ['Dalmatian', 'Defamation']
Daltynn: ['Dalton', 'Duality']
Danoje: ['Danone', 'Dane']
Darkrai: ['Darkie', 'Darker']
Darkus: ['Dark-us', 'Dark us']
Dasiy: ['Daisy', 'Dairy']
Daughtrey: ['Daughterly', 'Draughty']
Daxooka: ['ook']
Dazooka: ['Bazooka', 'Dhaka']
DeRatt: ['Ratty', 'Dealt']
Deadmau: ['Dead', 'Dama']
Deborahsamson: ['Hebraisms', "Hebraism's"]
Decomposers: ['Decompose-rs', 'Decompose rs']
Dekarious: ['Darius', 'Delirious']
Delhomme: ['Delmer', 'Dahomey']
Deodarant: ['Deodorant', 'Deodorants']
DeokWon: ['Deacon']
Derey: ['Dewey', 'Derek']
Deydey: ['Dewey', 'Heyday']
Dezyree: ['Degree', 'Decree']
Dialga: ['Di-alga', 'Di alga']
Dibnah: ['Dinah', 'Dina']
Dineil: ['Dine', 'Dingily']
Dinosuar: ['Dinosaur', 'Dinosaurs']
DioGaurdi: ['Dotard', 'Discord']
Dipsy: ['Dips', 'Tipsy']
Dirtbike: ['Dirt-bike', 'Dirt bike']
Dirtbikes: ['Dirt-bikes', 'Dirt bikes']
Dizzie: ['Dizzies', 'Dizzier']
Dobey: ['Do-bey', 'Do bey']
Dombie: ['Zombie', 'Dome']
Doofenshmirtz: ['Downshifts']
Dooooooo: []
Doot: ['Dot', 'toot']
Dorgen: ['Doreen', 'Doge']
Doubleback: ['Double-back', 'Double back']
Draculara: ['Dracula', "Dracula's"]
Draculaura: ['Dracula', "Dracula's"]
Dragonball: ['Dragon-ball', 'Dragon ball']
Dragonballs: ['Dragon-balls', 'Dragon balls']
Dragonforce: ['Dragon-force', 'Dragon force']
Drazic: ['Drastic', 'Draco']
Drooper: ['Droopier', 'Droop-er']
Drumset: ['Drum-set', 'Drum set']
Dugongs: ['Du-gongs', 'Du gongs']
Dwhight: ['Dwight', 'Delight']
Dynawrite: ['Dynamite', 'Dynamiter']
ECHIDNA: ['EDNA', 'ETCHING']
EEMU: ['EMU', 'TEEM']
EID: ['REID', 'ENID']
EKKA: ['YAKKA', 'PUKKA']
ELD: ['WELD', 'VELD']
ELSP: ['ESP', 'ELSE']
EMTs: ['EM-Ts', 'EM Ts']
Earded: ['Eared', 'Warded']
Earthday: ['Earth-day', 'Earth day']
Easers: ['Erasers', 'Easters']
Eatmon: ['Eaton', 'Eton']
Echidnas: ['Echidna', 'echidna']
Ecuavolley: ['Equally', 'Equivocally']
Eeaw: ['Ea']
Eeek: ['eek', 'Eek']
Egyption: ['Egypt-ion', 'Egypt ion']
Ellicottville: ['Millville', 'Hicksville']
Emenim: ['Emend', 'Eminem']
Emontional: ['Emotional', 'Emotionally']
Encouage: ['Encourage', 'Enrage']
Enrgy: ['Energy', 'Eng']
Espinosa: ['Espinoza', "Espinoza's"]
Essick: ['Es-sick', 'Es sick']
Evhop: ['whop', 'Whop']
Ewww: ['Eww']
Expierience: ['Experience', 'Experiences']
Eyore: ['Eeyore', 'Eyre']
FARMVILLE: ['FAMILIAL', 'FAMILY']
FELICEM: ['FELICE', "FELICE'S"]
FIREBIRDS: ['FIRE-BIRDS', 'FIRE BIRDS']
Famliy: ['Family', 'Foamy']
Fancisco: ['Francisco', 'Francisca']
Fantasmic: ['Fantastic', 'Fanta']
Farbrook: ['Far-brook', 'Far brook']
Farquaad: ['Farad', 'Faraday']
Farve: ['Fave', 'Fare']
Fatboy: ['Fat-boy', 'Fat boy']
Feathersword: ['Feathers-word', 'Feathers word']
Febuary: ['February', 'Rebury']
Fenanda: ['Fernando', 'Fenian']
Feraligatr: ['Frigate', 'Frignare']
Ferb: ['Fer', 'Feb']
Ferej: ['Ferule', 'Ferret']
Ficquette: ['Coquette', 'Marquette']
Figitus: ['Fights', 'Digits']
Finkle: ['tinkle', 'Winkle']
Firewords: ['Fire-words', 'Fire words']
Firezone: ['Fire-zone', 'Fire zone']
Flaversham: ['Flavors', 'Falasha']
Fleagle: ['Fl-eagle', 'Fl eagle']
Flocka: ['Flock', 'Flocks']
Folino: ['Folio', 'Folios']
Frair: ['Fr-air', 'Fr air']
Fredd: ['Freddy', 'Fred']
Fredricton: ['Fredric-ton', 'Fredric ton']
Frenchy: ['French', 'Frenches']
Frisbees: ["Frisbee's", 'Frisbee']
Froopy: ['Droopy', 'Troop']
Frosties: ['Frostiest', 'Fro-sties']
Fuh: ['Flush', 'ugh']
Funfest: ['Fun-fest', 'Fun fest']
FunnyTthings: ['Anythings', "Anything's"]
Funtown: ['Fun-town', 'Fun town']
Furrminals: ['Criminals', "Criminal's"]
Futbol: ['Futile', 'Fumble']
Futomaki: ['Automaker', 'Fotomat']
GOALLLLLLLLl: []
GREENBAY: ['GREEN-BAY', 'GREEN BAY']
GRRRRR: []
GRRRRRRRR: []
GULAB: ['GU-LAB', 'GU LAB']
Gabriola: ['Gabriela', 'Gabriel']
Gaidos: ['Gads', 'Hairdos']
Gallos: ['Gallows', 'Gallops']
Gameworks: ['Game-works', 'Game works']
Ganeesh: ['Ganesha', 'Gaines']
Gangar: ['Hangar', 'Gang']
Ganster: ['Gangster', 'Gaunter']
Gaskarth: ['Gasket', 'Gnash']
Gaspe: ['Gasped', 'Gasp']
Gday: ["G'day", 'Gay']
Gebby: ['Gibby', 'Gabby']
Geez: ['Gee', 'Jeez']
Geoji: ['Geo', 'Gobi']
Georgin: ['Georgina', 'Georgian']
Gerbie: ['Gerbil', 'Gerber']
Gerbrslassie: ['Guerrillas', 'Grasses']
Gergraphy: ['Geography', "Geography's"]
Ghoulia: ['Ghoul', 'Ghoulish']
Ginkotsu: ['Ginkgoes', "Ginkgo's"]
Gip: ['Grip', 'Gimp']
Girraffe: ['Giraffe', 'Giraffes']
Gligar: ['liger', 'Glare']
Gngerbread: ['Gingerbread', 'Cornbread']
Godess: ['Godless', 'Goddess']
Godivelle: ['Groveller', 'Godel']
Gokan: ['Groan', 'Golan']
Gontae: ['Gone', 'Monte']
Goooo: ['Goodo', 'Goo']
Gorrilla: ['Gorilla', 'Gorillas']
Governer: ['Govern-er', 'Govern er']
Grammys: ["Grammy's", 'Gram-mys']
Greenlantern: ['Green-lantern', 'Green lantern']
Gretsky: ['Gretzky', 'Greets']
Grisonich: ['Grinch', 'Garrison']
Growly: ['Growl', 'Growls']
Gryffindor: ['Grinder', 'Griffin']
Guatamalan: ['Guatemalan', 'Guatemalans']
Gullwings: ['Gull-wings', 'Gull wings']
Gung: ['Gungy', 'Gunge']
Gwandaloo: ['Vandal', 'Grandly']
HAHA: ['HA-HA', 'HA HA']
HAPPYYY: ['HAPPY', 'CHAPPY']
HODIE: ['HOODIE', 'HOD-IE']
HOWLLLLLL: ['HOWELL', 'HOWL']
HOWLLLLLLLLLLLLLLLLLLLLLLLLL: []
HaHaHaHa: []
Haaaaaaa: []
Haesun: ['Hamsun', 'Hazes']
Hahahahahahahah: []
Hahahahahohohehehe: []
Hajik: ['Hajji', 'Haiku']
Hakudoshi: ['Hawkish', 'Hackish']
Haleybug: ['Haley-bug', 'Haley bug']
Halloweeen: ['Halloween', 'Halloweens']
Hamiture: ['Mature', 'Maturer']
Handsel: ['Hansel', 'Handel']
Handwashing: ['Hand-washing', 'Hand washing']
Happpiness: ['Happiness', "Happiness's"]
Harborfest: ['Harbor-fest', 'Harbor fest']
Harverd: ['Harvard', 'Hared']
Haslett: ['Hassle', 'Hamlet']
Hazabel: ['Hazel', 'Izabella']
Heen: ['Helen', 'He-en']
Heinzman: ['Heinz-man', 'Heinz man']
Heiroglyphs: ['Hieroglyphs', "Hieroglyph's"]
Helpmanns: ['Helpmates', "Hellman's"]
Herbies: ['Derbies', 'Herbs']
Heriton: ['Heron', 'Triton']
Herkey: ['Her-key', 'Her key']
Hiathawa: ['Hathaway', "Hathaway's"]
Hickle: ['Tickle', 'Sickle']
Higitus: ['Hiatus', 'Digits']
Himay: ['Hi-may', 'Hi may']
Hmmmm: ['Hmm-mm', 'Hmm mm']
Hmmmmm: ['mmm']
Hoeungbo: ['Longbow', 'Hung']
Hokett: ['Hoke', 'Rockett']
Honaker: ['Honker', 'Honkers']
Hoorah: ['Howrah', 'Hooray']
Hornhead: ['Horn-head', 'Horn head']
Horoeka: ['Hookah', 'Hora']
Hortons: ["Horton's", 'Horton']
Hotdogs: ['Hot-dogs', 'Hot dogs']
Hotwheel: ['Hot-wheel', 'Hot wheel']
Howlll: ['Howl-ll', 'Howl ll']
Hownaz: ['Honda', 'Hon']
Huaaaaaaaa: []
Huckabay: ['Sickbay', 'Huck']
Hufflepuff: []
Humongasaur: ['Humongous', "Hmong's"]
Hundertwasser: ['Undertakers', "Undertaker's"]
Hunning: ['Sunning', 'Running']
Huntin: ['Hunting', 'Hunt-in']
Hurons: ["Huron's", 'Huron']
Hushhhh: ['shhh', 'Hush']
Hyob: ['Hob']
IASHA: ['TISHA', 'TASHA']
IHop: ['Hop', 'Hoopoe']
IPads: ["IPad's", 'IP-ads']
Ibrahimovich: []
Icenhour: []
Ick: ['Icky', 'Irk']
Iguanodons: ['Ugandans', 'Abandons']
Imbruglia: ['Imbroglio', 'Imbroglios']
Impreza: ['Impure', 'Impurer']
Incredibles: ['Incredible', 'Incredibly']
Incy: ['Inc', 'Icy']
Indelli: ['Indwell', 'Wendell']
Inuaysha: ['Inuyasha', 'Inrush']
Inukshuk: ['Inuyasha', 'wushu']
Ipad: ['IPad', "IPad's"]
Iphone: ['IPhone', 'Phone']
Ipod: ['Izod', 'IPod']
Ipods: ['Ids', "Izod's"]
Itsey: ['Its', 'Betsey']
Itsy: ['Its', "It's"]
Ivannas: ['Savannas', "Ivan's"]
J'Shaun: ['Shaun', 'Shauna']
JALFREZI: ['ALVAREZ', 'PALFREYS']
JAMUN: ['JAM-UN', 'JAM UN']
JAURIM: ['TARIM', 'PURIM']
JAWAN: ['JAW-AN', 'JAW AN']
JSaylee: ['Saleen', 'Jaylen']
Ja'Nese: ['Javanese', 'Japanese']
Ja'nese: ['Javanese', 'Japanese']
Jabberwock: ['Jabberwocky', 'Jabber']
Jack'O: ["Jack's", 'Jack']
Jakken: ['Jake', 'Waken']
Jakotsu: ['Jackpots', 'Jabots']
Janggyeong: ['jajangmyeon', 'Jangling']
Japenese: ['Japanese', 'Japaneses']
Jaqula: ['Julia', 'Raquel']
Jassid: ['Kassidy', 'Cassidy']
Jassids: ["Cassidy's", 'Kassidy']
Jawas: ['Jaw-as', 'Jaw as']
Jedis: ["Jedi's", 'Jed-is']
Jelenkovic: ['Jelani']
Jeockbyeock: ['Chockablock', 'Jockeyed']
Jerreck: ['Jerk', 'Merrick']
Jetsons: ['Jet-sons', 'Jet sons']
Jiminy: ['Jinny', 'Jimmy']
Jinman: ['Jinan', 'Binman']
Johannasburg: ['Johannesburg', "Johannesburg's"]
Jubjub: ['Jujube', 'wub-wub']
Juney: ['June', 'Journey']
KAYAKERS: ['KAYAKS', 'KAYAKED']
KENNYA: ['KENYA', 'KENNY']
KESAR: ['CESAR', 'CAESAR']
KHEER: ['SHEER', 'KHMER']
KHeard: ['Heard', 'Herd']
Kabobs: ['Nabobs', "Nabob's"]
Kahimi: ['Kashmir', 'Kimchi']
Kahtya: ['Kaya', 'Katy']
Kaihmi: ['Kashmir', 'Kimchi']
Kaledrick: ['Kendrick', 'Baldric']
Kamikazi: ['Kamikaze', 'Kamikazes']
Kamodo: ['moo', 'Kimono']
Kanabrocki: ['Knock', 'Pawnbroker']
Kandai: ['Kaunda', 'Kana']
Kauboi: ['Kauai', 'Kablooie']
Kawyanda: ['Kayna', 'Kaunda']
Kayakers: ['Kayaks', 'Kayaked']
Kebler: ['Kepler', 'Keller']
Kebo: ['Keo', 'Kerb']
Keeaydin: ['Keewaydin', 'Kneading']
Keeywadin: ['Keewaydin', 'Keewatin']
Kellogs: ["Kellogg's", 'Kellogg']
Kgalema: ['Ngaliema', 'Kemah']
Khristoff: ['Kristoff', 'Kristy']
Kilala: ['lala', 'Kill']
Kilmanjaro: ['Kilimanjaro', "Kilimanjaro's"]
Kimbo: ['Limbo', 'Bimbo']
Kims: ["Kim's", 'Kim']
Kittins: ['Kit-tins', 'Kit tins']
Kittyville: ['Millville', 'Kettle']
Klaressa: ['Clarissa', 'Glares']
Kohaka: ['haka', 'Kojak']
Komatik: ['Somatic', 'Kodak']
Koodo: ['Goodo', 'Voodoo']
Koosh: ['ooh', 'whoosh']
Kopites: ['Kites', 'Spites']
Kowhai: ['Kiowa', 'Khaki']
Krabby: ['Grabby', 'Crabby']
Krabs: ['Kr-abs', 'Kr abs']
Krakauer: ['Kruger', 'Kramer']
Kreme: ['Creme', 'ree']
Kreski: ['Kerensky', 'Kresge']
Kripsy: ['Krispy', 'Kris']
Krusty: ['Trusty', 'Kristy']
Kstrong: ['stong', 'Strong']
Kualii: ['Kali', 'Kunai']
Kubel: ['Kublai', 'Gumbel']
Kuji: ['Fuji', 'Kunai']
Kwy: ['Ky', 'Kw']
Kyokotst: ["Kyoto's", 'Koot']
L'Arliquin: ['Harlequin', 'Liukin']
L'Opera: ['Opera', 'Oprah']
LEGOs: ['LEG-Os', 'LEG Os']
LSU: ['LU', 'LS']
La'Monta: ['Monta', 'Lamont']
Lacienega: ['Lacing', 'Lucien']
Laerning: ['Learning', 'Warning']
Lakers: ['Lake-rs', 'Lake rs']
Lalaloopsies: ['Lalaloopsy', 'Lapses']
Lamborghinis: ["Lamborghini's", 'Lamborghini']
Lambourgini: ['Lamborghini', "Lamborghini's"]
Lambroghini: ['Lamborghini', "Lamborghini's"]
LatinViaProverbs: []
Latkes: ['Lakes', 'Lattes']
LeAnn: ['Le-Ann', 'Le Ann']
LeBron: ['Byron', 'Brown']
Leafhoppers: ['Leaf-hoppers', 'Leaf hoppers']
Leatherback: ['Leather-back', 'Leather back']
Leeney: ['Weeny', 'Teeny']
Leghoul: ['Le-ghoul', 'Le ghoul']
Legos: ["Lego's", 'Leos']
Leiths: ['Lets', 'Leis']
Lemmers: ['Lemme-rs', 'Lemme rs']
Lemonds: ['Lemons', 'Lemonades']
Leprachaun: ['Leprechaun', 'Leprechauns']
Lesht: ['Les-ht', 'Les ht']
Lestath: ['Lest', 'Lesotho']
Letterland: ['Letter-land', 'Letter land']
Lifemate: ['Life-mate', 'Life mate']
Ligers: ['Lingers', 'Liger']
Lightnin: ['Lightning', 'Lightnings']
Lightyear: ['Light-year', 'Light year']
Ligno: ['Lino', 'Lingo']
Lippizan: ['Lipizzan', 'Lipizzaner']
Litttle: ['Little', 'Littler']
Liverbird: ['Liver-bird', 'Liver bird']
Lizz'y: ['Lizzy', "Lizzy's"]
Lizzards: ['Lizards', "Lizard's"]
Lleu: ['Lyle', 'Lieu']
Loblaw: ['Lob-law', 'Lob law']
Lochness: ['Lowness', 'Lioness']
Longboards: ['Long-boards', 'Long boards']
Loompas: ['Loom-pas', 'Loom pas']
Lorax: ['Lora', 'Borax']
Louisianna: ['Louisiana', 'Louisianan']
Lovegood: ['Love-good', 'Love good']
Lowriders: ['Low-riders', 'Low riders']
Lurky: ['Lurk', 'Murky']
MEHNDI: ['MEND', 'MENDING']
MESSI: ['MES-SI', 'MES SI']
MLB: ['ML', 'MB']
MLK: ['MILK', 'ML']
MMMMMM: []
MMMMMMM: []
MNational: ['National', 'Nationally']
Maaa: ['Maya', 'Mara']
Macarons: ['Macaroons', 'Macaronis']
Machester: ['Manchester', 'Mach-ester']
Mackehzie: ['Mackenzie', 'McKenzie']
Malfoy: ['Malory', 'Mallory']
Mamama: ['Mama-ma', 'Mama ma']
Mancheay: ['Manichean', 'Manley']
Manhart: ['Man-hart', 'Man hart']
Mapau: ['Map', 'Maputo']
Mapleleaf: ['Maple-leaf', 'Maple leaf']
Marbleworks: ['Marble-works', 'Marble works']
Margies: ["Margie's", 'Margie']
Marielaina: ['Mariana', 'Maritain']
Marieski: ['Marie-ski', 'Marie ski']
Marksy: ['Marks', "Mark's"]
Maroun: ['Matron', 'Maroon']
Marshmellows: ['Marsh-mellows', 'Marsh mellows']
Massachusette: ['Massachusetts', "Massachusetts's"]
Masscre: ['Massacre', 'Massacres']
Materiais: ['Materialise', 'Materials']
Matinicus: ['Martinis', 'Matins']
Matoaka: ['Jataka', 'Mintaka']
Maussolleion: ['Mussolini', 'Mullion']
Mav: ['Ma', 'May']
Maycomb: ['May-comb', 'May comb']
McDreamy: ['scream', 'Scream']
McFlurries: ['Flurries', "McClure's"]
McNuggets: ['Magnets']
McQuain: ['McCain', 'Quin']
McQueens: ["McQueen's", 'McQueen']
McSteamy: ['Stamp']
Medvac: ['Med-vac', 'Med vac']
Megazoids: ['Megabits', "Megabit's"]
Melmen: ['Mel-men', 'Mel men']
Merekats: ['Meerkat', 'Merits']
Miguels: ["Miguel's", 'Miguel']
Mikevick: []
Militat: ['Militate', 'Militant']
Minecraftia: ['Minecraft', 'minecraft']
Minetto: ['Minuet', 'Mitt']
Minichiello: ['Winchell', 'Mitchell']
Minimesme: ['Minimise', 'Minims']
Minkie: ['Pinkie', 'Minnie']
Minun: ['Mi-nun', 'Mi nun']
Mirim: ['Miriam', 'Mi-rim']
Mitko: ['Mikado', 'Mitt']
Mmmmm: ['mmm', 'Mmm']
Mmmmmm: ['mmm', 'Mmm']
Monarail: ['Mona-rail', 'Mona rail']
Mondolkiri: ['Montgolfier', 'Mongolic']
Monkee: ['Monkey', 'Monk']
Monoploy: ['Mono-ploy', 'Mono ploy']
Moooo: ['Moo', 'yoo-hoo']
Moooooo: ['Moo']
Mooooooooooooooo: []
Motlanthe: ['Melaine', 'Moan']
Motobike: ['Motorbike', 'Motorbikes']
Motorcyle: ['Motorcycle', 'motocycle']
Muertos: ["Merton's", 'Metros']
Muffie: ['Muffle', 'Muffin']
Mukotsu: ['Mots', 'Muskets']
Mulisha: ['Mulish', 'Mulishly']
Munce: ['Munches', 'Ounce']
Muralitharan: ['Malthusian', 'Proletarian']
NANTA: ['NAN-TA', 'NAN TA']
NATALEM: ['NATAL-EM', 'NATAL EM']
NOTUS: ['NOT-US', 'NOT US']
NYPD: ['NY-PD', 'NY PD']
Naad: ['Naiad', 'Na-ad']
Nacher: ['Watcher', 'Thacher']
Nanoscope: ['otoscope', 'Nonstop']
Nascar: ['Na-scar', 'Na scar']
Nascars: ['Na-scars', 'Na scars']
Neemo: ['Nee-mo', 'Nee mo']
Neewo: ['New', 'Nee']
Nemmo: ['Neyo', 'Nero']
Nessesity: ['Necessity', 'Messiest']
Nevra: ['Neva', 'Never']
Newfies: ['Newbies', "Newbie's"]
Newin: ['New-in', 'New in']
Nextel: ['Next', 'Nette']
Nezia: ['Noelia', 'Keziah']
Niagra: ['Niagara', 'Viagra']
Nigiri: ['Nigeria', 'Niger']
Ninetendo: ['Nintendo', "Nintendo's"]
Ninjago: ['Ninja-go', 'Ninja go']
Nitroade: ['Nitrate', 'Nitro']
Niver: ['Naiver', 'River']
Nog: ['Nong', 'No']
Noleens: ["Noreen's", 'Colleens']
Noob: ['No-ob', 'No ob']
Noooo: ['yoo-hoo', 'woooosh']
Nordy: ['Wordy', 'Noddy']
Nowitzki: ['Howitzer', 'Switz']
Ntiaj: ['Nokia', 'Ninna']
Nunavat: ['Nunavut', "Nunavut's"]
Nunchuks: ["Nunki's", 'munch']
Nunu: ['Nu-nu', 'Nu nu']
Nunuvat: ['Nunavut', "Nunavut's"]
O'Lanterns: ['Lanterns', "Lantern's"]
OKCPS: ['OK-CPS', 'OK CPS']
OOOOO: []
OOOOOOOO: []
OOOP: ['WOOP', 'POOP']
ORISKANY: ['ORISON', 'RISKING']
OSU: ['OS', 'USU']
Oariskany: ['Oriskany', 'Orison']
Obamas: ["Obama's", 'Obama']
Ochi: ['Och', 'Orchid']
Ocotber: ['October', 'Octobers']
Oddar: ['Odder', 'Odd']
Olivarez: ['Alvarez', 'Olives']
Olypmics: ['Olympics', "Olympic's"]
Omakaya: []
Omakayas: []
Omalley: ['Om-alley', 'Om alley']
Omnitrex: ['Omnivores', "Omnivore's"]
Oompa: ['Oompah', 'Oom-pah']
Oooo: ['Ogopogo', 'hoopoe']
Ooooo: ['yoo-hoo', 'woooosh']
Oooooh: ['woooosh', 'Woooosh']
Ooooooo: []
OpFor: ['Op-For', 'Op For']
Orcas: ['Orc-as', 'Orc as']
Oreos: ["Oreo's", 'Ores']
Orlano: ['Orlando', 'Oran']
Orsei: ['Ore', 'Ours']
Ortavon: ['Octavian', 'Davon']
Oullivan: ['Sullivan', 'Olivia']
Outerbanks: ['Outer-banks', 'Outer banks']
Ovechkin: ['Overcooking', 'Overcharging']
Ozmars: ['Oz-mars', 'Oz mars']
PANEER: ['PANE-ER', 'PANE ER']
PAPILIO: ['PAIL', 'PAPILLA']
PBWorks: ['PB-Works', 'PB Works']
PODD: ['PO-DD', 'PO DD']
PULAO: ['PU-LAO', 'PU LAO']
Pab: ['Pb', 'Pa']
Pademelons: ['Watermelons', "Watermelon's"]
Pagaini: ['Paganini', 'Pagan']
Pairalee: ['Parolee', 'Parable']
Paityne: ['Payne', 'Paine']
Palkia: ['Paglia', 'Palikir']
Pandekager: ['Poundage', 'Xander']
Pangea: ['Pangaea', 'Pang-ea']
Panjeon: ['Pantheon', 'Puncheon']
Papouhi: ['Papi', 'Papyri']
Pataky: ['Partway', 'Partake']
Patricks: ["Patrick's", 'Pat-ricks']
PawPaw: ['Paw-Paw', 'Paw Paw']
Pecori: ['Peoria', 'Pechora']
PeeWee: ['Pee-Wee', 'Pee Wee']
Peekapoo: ['Peekaboo', 'Peep']
Peepsical: ['Popsicle', 'Pascal']
Peis: ['Penis', "Pei's"]
Pelumi: ['Plum', 'Plumier']
Pendanski: ['Pendants', "Pendant's"]
Penguine: ['Penguin', 'Penguins']
Peppa: ['Pep-pa', 'Pep pa']
Perc: ['Percy', 'Perch']
Petanque: ['Petain', 'Pertained']
Pharoahs: ['Pharaohs', "Pharaoh's"]
Phillies: ['Phil-lies', 'Phil lies']
Piachu: ['Pikachu', 'Poach']
Pichadello: ['Piccadilly', 'Peccadillo']
Pichu: ['Pikachu', 'Pitch']
Pickadello: ['Picador', 'Piccadilly']
Pikora: ['Prior', 'Piker']
Pinchbug: ['Pinch-bug', 'Pinch bug']
Piplup: ['Pileup', 'Popup']
Pippen: ['Pip-pen', 'Pip pen']
Piraka: ['Prank', 'Praia']
Piriati: ['Pirating', 'Pirate']
Pitbulls: ['Pit-bulls', 'Pit bulls']
PlayPumps: ['Play-Pumps', 'Play Pumps']
Playstation: ['Play-station', 'Play station']
Ploar: ['Pl-oar', 'Pl oar']
Plusle: ['Pluses', 'Plus']
Pocahantas: ['Pocahontas', "Pocahontas's"]
Pokeball: ['Poke-ball', 'Poke ball']
Polomolu: ['Polynomial', 'Plymouth']
Popsicles: ["Popsicle's", 'Popsicle']
Poseiden: ['Poseidon', "Poseidon's"]
Pourer: ['Pour-er', 'Pour er']
Powerpuff: ['Power-puff', 'Power puff']
Prarie: ['Prairie', 'Prairies']
Preah: ['Preach', 'Preachy']
Preditor: ['Predictor', 'Pr-editor']
Prelutsky: ['Pelts', 'Preludes']
Priebe: ['Prithee', 'Perigee']
Ptptptpt: ['Putt-putt']
Puffkin: ['Puff-kin', 'Puff kin']
Puggles: ['Muggles', 'Juggles']
Pumba: ['Puma', 'Zumba']
Pumbaa: ['Puma', 'Zumba']
Pumkin: ['Pumpkin', 'Puking']
Punxy: ['Puny', 'Puns']
Pupas: ["Pupa's", 'Pup-as']
Puyol: ['Pol', 'Payola']
Qq: ['Q']
Quarrelsom: ['Quarrelsome', 'Quarrels-om']
Queensryche: ['Quencher', 'Queens']
QuikJean: ['Quicken', 'Quickening']
Quinceanera: ['Quinten']
RASMALAI: ['SOMALI', 'RASCAL']
RAWR: ['RAWER', 'RAW']
RICCOTTA: ['RICOTTA', "RICOTTA'S"]
ROARRRRRR: ['ROARER', 'ROARERS']
ROMAE: ['ROME', 'ROMAINE']
RRRRRAWARR: []
Rabbids: ['Rabbis', 'Rabbits']
Raccon: ['Raccoon', 'Racoon']
Raccoons: ["Raccoon's", 'Raccoon']
Racecar: ['Race-car', 'Race car']
Raejauna: ['Jejuna', 'Reyna']
Raejuana: ['Jejuna', 'Marijuana']
Raffiki: ['Rafiki', 'Raffia']
Raichu: ['Rich', 'Roach']
Railfanespee: ['Ravines', 'Realness']
Rainbowa: ['Rainbow', 'Rainbows']
Ranklin: ['Rankling', 'Rankin']
Ratanakiri: ['Rattan', 'Ranker']
Ravenclaw: ['Raven-claw', 'Raven claw']
Rayuela: ['Raquel', 'Raul']
Rebit: ['Re-bit', 'Re bit']
Redwings: ['Red-wings', 'Red wings']
Reeses: ["Reese's", 'Reese']
Renardius: ['Radius', 'Rewards']
Renkotsu: ['Rents', "Rent's"]
Renta: ['Rental', 'Rent']
Retreiver: ['Retriever', 'Retrievers']
Retreivers: ['Retrievers', "Retriever's"]
Reventon: ['Reinventing', 'Seventeen']
Revoution: ['Revolution', 'Revocation']
Rexes: ['Rex-es', 'Rex es']
Rhinocerous: ['Rhinoceros', "Rhinoceros's"]
Riccar: ['Ricardo', 'Wicca']
Rieng: ['Ring', 'Ruing']
Rifik: ['Rafiki', 'Risk']
Riflery: ['Rifler', 'Riflers']
Riiiight: ['Right', 'Rights']
Rimu: ['Rim', 'Rims']
Rintoo: ['Ringo', 'Rhino']
Robjent: ['bento', 'Ribbet']
Rochadd: ['Rocha-dd', 'Rocha dd']
Rockafella: ['Rockwell', 'Rockfall']
Rockin: ['Rocking', 'Rock-in']
Rockstar: ['Rocks-tar', 'Rocks tar']
Rodail: ['Rod-ail', 'Rod ail']
Rollercoasters: ['Roller-coasters', 'Roller coasters']
Romein: ['Rome-in', 'Rome in']
Roofus: ['Roof-us', 'Roof us']
Rorabacher: ['Rancher', 'Roach']
Rowethorpe: ['Rower', 'Thorpe']
Ruf: ['Ruff', 'Ru']
S'mores: ['Sores', 'Stores']
SAMANAK: ['SAMANTHA', 'SEAMAN']
SMARTBoard: ['SMART-Board', 'SMART Board']
SPOOOOKS: ['SPOOKS', "SPOOK'S"]
SSSHHH: ['SHH']
SSSSSS: ['SSS-SSS', 'SSS SSS']
SSSSSSSS: []
SUMUS: ['SUM-US', 'SUM US']
SUNY: ['SUNNY', 'SUN']
SUVs: ['SUV', "UV's"]
SVMS: ['SUMS', "SM'S"]
SYEP: ['YEP', 'SEP']
Saffir: ['Staffer', 'Shaffer']
Sahta: ['Satay', 'Satan']
Sailers: ['Wailers', 'Silvers']
Sakic: ['Saki', 'Sakai']
Salior: ['Savior', 'Sailor']
Saltpans: ['Salt-pans', 'Salt pans']
Samanak: ['Samantha', 'Seaman']
Samgyetang: ['Slam-bang', 'Saiyan']
Samoyeds: ["Samoyed's", 'Samoyed']
Samuri: ['Samurai', 'Samurais']
Sango: ['San-go', 'San go']
Santuary: ['Sanctuary', 'Statuary']
Sanzang: ['Swansong', 'Snoozing']
Sarova: ['Sara', 'Saratov']
Satalites: ['Satellites', 'Fatalities']
Satchmo: ['Schmo', 'Satch']
Satchmouth: ['Schmo', 'Satch']
Saurapods: ['Sauropods', "Sauropod's"]
Schielie: ['Suchlike', 'Schiller']
Schot: ['Sc-hot', 'Sc hot']
Scire: ['Sci-re', 'Sci re']
Scooy: ['Sooty', 'Sooky']
Screem: ['Scree', 'Screes']
Seabold: ['Sea-bold', 'Sea bold']
Sealicious: ['Salacious', 'Malicious']
Sease: ['Seas', 'Tease']
Sebby: ['Debby', 'Stubby']
Sedquan: ['Sedan', 'Sequin']
Semiphredo: ['Semaphored', 'Semaphore']
Sesshomaru: ['Seashore']
Shacoby: ['Shabby', 'Shaky']
Shaggys: ['Shaggy', 'Shays']
Shanacia: ['Shana', 'Shanghai']
Shaq: ['Shay', 'Shaw']
Sharpay: ['Sharply', 'Sharp']
Shaslick: ['Slick', 'hick']
Shhhh: ['Shhh', 'Shh']
Shhhhhh: ['Shhh', 'Shh']
Shhhhhhh: ['Shhh']
Shielie: ['Shiite', 'Shield']
Shife: ['Shire', 'Shine']
Shimerda: ['Shimmered', 'Shimmer']
Shimerdas: ['Shimmers', 'Chimeras']
Shiney: ['Shiny', 'Shine']
Shitszu: ['Shiatsu', 'Shits']
Shreks: ['Shrieks', "Shrek's"]
Shyvez: ['Shove', 'Shave']
Simcheong: ['Smooching', 'Smirching']
Singerline: ['Singer-line', 'Singer line']
Singity: ['Salinity', 'Stingy']
Sirabi: ['Shira', 'Sarai']
Sixburgh: ['Six-burgh', 'Six burgh']
Skevos: ['Servos', "Servo's"]
Skidders: ['Skiers', 'skidder']
Skywalker: ['Sky-walker', 'Sky walker']
Sles: ['Soles', 'Slues']
Slewfoot: ['Slew-foot', 'Slew foot']
Slurpees: ["Slurpee's", 'Slur-pees']
Slushies: ['Slushiest', 'Slushiness']
Slytherin: ['Slithering', 'Slathering']
Smackdown: ['Smack-down', 'Smack down']
Smartboard: ['Smart-board', 'Smart board']
Smellmo: ['Smell-mo', 'Smell mo']
Smouse: ['Souse', 'Spouse']
Smuggs: ['Smug-gs', 'Smug gs']
Sneetches: ['Speeches', 'Snitches']
Snitchell: ['Snitch-ell', 'Snitch ell']
Snitcher: ['Snitch-er', 'Snitch er']
Snowborder: ['Snowboarder', 'Snow-border']
Snowmobiler: ['Snowmobile', 'Snowmobiles']
Snufflecake: ['Snuffle-cake', 'Snuffle cake']
Sofronie: ['Sooners', 'Saffron']
Softee: ['Softener', 'Softer']
Soleh: ['Sol-eh', 'Sol eh']
SongSisters: ['Song-Sisters', 'Song Sisters']
Soondae: ['Sundae', 'Sooner']
Soondaechon: ['Stanchion', 'Snatching']
Soooo: ['yoo-hoo', 'woooosh']
Southbank: ['South-bank', 'South bank']
Southington: ['Stanton', 'Sounding']
Soyee: ['Soy', 'See']
Spankys: ['Spanks', "Spank's"]
Speedee: ['Speeder', 'Speed']
Speedracer: ['Speed-racer', 'Speed racer']
Spicey: ['Spicy', 'Spice']
Splank: ['Sp-lank', 'Sp lank']
Splink: ['Sp-link', 'Sp link']
Splinks: ['Sp-links', 'Sp links']
SquarePants: ['Square-Pants', 'Square Pants']
Squarepants: ['Square-pants', 'Square pants']
Squidward: ['Squid-ward', 'Squid ward']
Ssshhh: ['shhh', 'Shhh']
Sssss: ['ssss', 'Sssssss']
Starfox: ['Star-fox', 'Star fox']
Stockers: ['St-ockers', 'St ockers']
Stompin: ['Stomping', 'Stomp-in']
Stratocarster: ['Streetcars', "Streetcar's"]
Strawberrys: ["Strawberry's", 'Strawberry']
Styracosaurous: ['Styracosaurus', 'Tyrannosaurus']
Successmaker: ['Success-maker', 'Success maker']
Sugung: ['Sung', 'Surging']
Suikotsu: ['Suits', 'Sickouts']
Sukhee: ['Squee', 'Skeet']
Sungyu: ['Sung', "Sung's"]
Sunprints: ['Sun-prints', 'Sun prints']
Susans: ["Susan's", 'Susan']
Sutters: ['Stutters', 'Sputters']
Suyuan: ['Susan', 'Sudan']
Svay: ['Say', 'Sway']
Swimity: ['Swimsuit', 'Swim']
Swiper: ['Swipe', 'Swipes']
TABLAOS: ['TABLA-OS', 'TABLA OS']
TELETUBBIES: ['TELETYPES', 'TOILETRIES']
TERRARUM: ['TERRARIUM', 'TERRA-RUM']
TERRON: ['TERR-ON', 'TERR ON']
TMNT: ['TM-NT', 'TM NT']
TOGETER: ['TOGETHER', 'TOTTER']
TREATERS: ['TR-EATERS', 'TR EATERS']
TRex: ['TR-ex', 'TR ex']
Taavo: ['Ta-avo', 'Ta avo']
Taehoon: ['Taejon', 'Typhoon']
Tamborines: ['Tambourines', "Tambourine's"]
Tangalooma: ['Tangelo', 'Tantalum']
Tangerina: ['Tangerine', 'Tangerines']
Tarantualas: ['Tarantulas', "Tarantula's"]
Tarheel: ['Tar-heel', 'Tar heel']
Tarheels: ['Tar-heels', 'Tar heels']
Tator: ['Tat-or', 'Tat or']
Taukelina: ['Tapeline', 'Tackling']
Tayor: ['Taylor', 'Tabor']
Teachey: ['Teaches', 'Teacher']
TeenLife: ['Teen-Life', 'Teen Life']
Teepee: ['Tee-pee', 'Tee pee']
Teighlors: ['Tailors', "Tailor's"]
Teletubbie: ['Teletubbies', 'Teletype']
Teletubby: ['Teletubbies', 'Teletype']
Temaki: ['Teak', 'Tweak']
TenTen: ['Ten-Ten', 'Ten Ten']
Thankgiving: ['Thanksgiving', 'Thank-giving']
Thanksgivng: ['Thanksgiving', 'Thanksgivings']
Thaum: ['Thump', 'Thumb']
Timberwolves: ['Timber-wolves', 'Timber wolves']
Timmies: ['Tummies', 'Jimmies']
Tinky: ['Tiny', 'Winky']
Toine: ['Tone', 'Tine']
Tokey: ['To-key', 'To key']
Tolee: ['To-lee', 'To lee']
Toliet: ['Toilet', 'Tole']
Tooot: ['Toot', 'Toots']
Toops: ['Troops', 'To-ops']
Tootise: ['Tootsie', 'Toots']
Topkapi: ['Topeka', 'Topic']
Toppum: ['Tum', 'Topple']
Toyon: ['Toy-on', 'Toy on']
Tranformers: ['Transformers', "Transformer's"]
Treegap: ['Tree-gap', 'Tree gap']
Treng: ['Treeing', 'Trent']
Tricerotops: ['Triceratops', "Triceratops's"]
Trilville: ['Trivially', 'Millville']
Tubmam: ['Tub-mam', 'Tub mam']
Tucan: ['Tuscan', 'Tu-can']
TuneUps: ['Tune-Ups', 'Tune Ups']
Turnity: ['Trinity', 'Turnip']
Tweetsie: ['Tweets', 'Tweeter']
Txhua: ['Thud', 'Thunk']
Txuag: ['Tugs', 'Tags']
Tzus: ['Tus', "Tu's"]
UMMMM: []
UMQUAM: ['MAUGHAM', 'IMAM']
Uasin: ['Using', 'Basin']
Ug: ['Ugh', 'U']
Ugg: ['Ugh', 'Egg']
Ugli: ['Uglier', 'Ugly']
Umanga: ['Manga', 'Ubangi']
Umbrette: ['betten', 'Umbriel']
Ummm: ['Um-mm', 'Um mm']
Unicycling: ['Uni-cycling', 'Uni cycling']
Unphotograph: ['Rephotograph', 'Photograph']
UpSideDown: []
Upsidedown: ['Upside-down', 'Upside down']
Urkel: ['Uriel', 'Terkel']
Usain: ['Using', 'saiyan']
Usdeto: ['Undertow', 'Usenet']
Utonium: ['Uranium', 'Titanium']
VFL: ['VF', 'FL']
Valetine: ['Valentine', 'Vale-tine']
Veloceraptors: ['Ulcerates', 'Protoceratops']
Venem: ['Verne', 'Venue']
Veng: ['Veg', 'Vent']
Ventriliquist: ['Ventriloquist', 'Ventriloquists']
Vihear: ['Vi-hear', 'Vi hear']
Vilgax: ['Volga', 'Vulgar']
Vinkel: ['Vinyl', 'tinkle']
Viszla: ['Vistula', 'Visas']
Voavanga: ['Vang']
Vocabula: ['Vocabulary', 'Vocable']
Volkswagon: ['Volkswagen', "Volkswagen's"]
Vollyball: ['Volleyball', 'Volleyballs']
VonDissen: []
Vulcans: ["Vulcan's", 'Vulcan']
Vulpix: ['Publix', 'gulp']
WDs: ['Wis', 'Was']
WHEEEE: ['WHEEZE', 'WHEE']
WOOO: ['WOO', 'WOOS']
WaXhaw: ['haw', 'Wah']
Walders: ['Waders', 'Welders']
Walkin: ['Walking', 'Walk-in']
Walkity: ['Walt', 'Walk']
Walty: ['Walt', 'Wealthy']
Wasanthi: ["Wasn't"]
Washinton: ['Washington', "Washington's"]
Wassily: ['Wassail', 'Wassails']
Wassup: ['Was-sup', 'Was sup']
WaterPark: ['Water-Park', 'Water Park']
Weasle: ['Weaseled', 'Wesley']
Weeeee: ['Wheeze', 'Weezer']
Weeeeeeeee: []
Weet: ['Weest', 'Wet']
Welberto: ['Wilbert', 'Delbert']
Welome: ['Welcome', 'Whelmed']
Weuweuweuweu: []
Wheeeee: ['Wheeze', 'Whee']
Wheeeeeeee: ['Wheeze']
Wheeeeeeeeee: []
Whipbird: ['Whip-bird', 'Whip bird']
Whooie: ['Wookie', 'Woozier']
Whooooo: ['Woooosh', 'Whoso']
Whooooooo: ['Woooosh']
Wiggan: ['Wiggins', 'Wigging']
Wikepedia: ['Wikipedia', "Wikipedia's"]
Wildmut: ['Wildest', 'Wildcat']
Willlllllllly: []
Wimbely: ['Kimberly', 'Nimbly']
Wimbley: ['Womble', 'Wimple']
Wincy: ['Winy', 'Winky']
Woah: ['Wah', 'Woad']
Wobbuffet: ['Buffet', 'Wobbled']
Wobles: ['Wombles', 'Wobbles']
Wocket: ['Wicket', 'Socket']
Wolfert: ['Wolfe-rt', 'Wolfe rt']
Wonderwoman: ['Wonder-woman', 'Wonder woman']
Wooly: ['Woolly', 'Wool']
Wooooo: ['Woooosh', 'Woo-hoo']
Wrestlemania: ['Wrestle-mania', 'Wrestle mania']
Wukong: ['Wong', 'dugong']
XBOX: ['BOX', 'XOXO']
Xax: ['Xx', 'Xxx']
Xerces: ['Xerxes', 'Pierces']
Xingyiquan: ['Pinyin']
Xmen: ['Xeon', 'Omen']
Xylophory: ['Xylophone']
YIPEE: ['YIPPEE', 'YIPE']
Yewww: ['Yew', 'Yews']
Yipeeeeee: ['Yippee', 'Yipe']
Yippeee: ['Yippee', 'Yipped']
Yooks: ['Yonks', 'Yolks']
Youtube: ['You-tube', 'You tube']
Yterbium: ['Ytterbium', 'Terbium']
Yumm: ['Yummy', 'Yum']
Yummmmm: ['mmm']
ZOIE: ['ZOE', 'ZONE']
ZZZZZZZZ: []
ZZZZZZZZZZZZZ: []
Zatch: ['Watch', 'Satch']
Zeeesh: ['Zeus', 'Zeke']
Zeen: ['Zen', 'Ween']
Zerosum: ['Zeros-um', 'Zeros um']
Zipline: ['Zip-line', 'Zip line']
Zizzer: ['Sizzler', 'Quizzer']
Zourkhaneh: []
Zownir: ['Downier', 'Zoning']
Zuckerberg: ['Knickerbocker', 'Schoenberg']
Zurawell: ['Farewell', 'crawl']
Zzzzz: ['Zzzz', 'zzz']
aaaaaaaah: []
aaaaaah: ['aah']
abandonded: ['abandoned', 'abandon']
aerospaceguide: ['aerospace-guide', 'aerospace guide']
afteroon: ['afternoon', 'pteranodon']
agaist: ['against', 'aghast']
agevisses: ['advises', 'ogresses']
agilities: ['abilities', 'facilities']
agricolae: ['Agricola', "Agricola's"]
agricolam: ['Agricola', "Agricola's"]
aiquilla: ['quill', 'Aquila']
alertprogram: ['alert-program', 'alert program']
allways: ['hallways', 'all-ways']
amans: ['am-ans', 'am ans']
ambulaverunt: ['ambulant', 'ambivalent']
ammusement: ['amusement', 'amusements']
amuck: ['muck', 'mucky']
andindian: ['Bandidas', 'unwinding']
anenome: ['envenom', 'anemone']
annielee: ['annealed', 'Danielle']
antenae: ['antennae', 'ante-nae']
anthing: ['anything', 'ant-hing']
anxii: ['an-xii', 'an xii']
anyother: ['any-other', 'any other']
apavuisset: ['atavist', 'apiarist']
apparuit: ['apart', 'apparent']
appetit: ['appetite', 'appetites']
appitites: ['appetites', "appetite's"]
aprillittle: ['prattle', 'prattler']
ard: ['yard', 'ward']
ared: ['tared', 'rared']
armidillo: ['armadillo', 'armadillos']
arrgh: ['argh', 'arghh']
arrving: ['arriving', 'earring']
artean: ['tartan', 'marten']
astenosphere: ['atmosphere', 'ionosphere']
asthensophere: ['Pedosphere']
astr: ['astir', 'aster']
atas: ['atlas', 'at-as']
atch: ['watch', 'patch']
atheletes: ['athletes', "athlete's"]
attendent: ['attendant', 'attendants']
aufwiedersehen: []
auncle: ['uncle', 'uncles']
autobots: ['auto-bots', 'auto bots']
awh: ['aw', 'ah']
awsome: ['awesome', 'aw-some']
babys: ["baby's", 'bays']
backbends: ['back-bends', 'back bends']
backflip: ['back-flip', 'back flip']
backflips: ['back-flips', 'back flips']
baina: ['brain', 'basin']
balancebeam: ['balance-beam', 'balance beam']
banaka: ['ban-aka', 'ban aka']
bandaid: ['band-aid', 'band aid']
barbque: ['barbeque', 'barque']
batean: ['bate-an', 'bate an']
batzuk: ['batik', 'batiks']
batzutan: ['batsman', 'rambutan']
beatiful: ['beautiful', 'beautifully']
beatuiful: ['beautiful', 'beautifully']
beauiful: ['beautiful', 'beautifully']
beauitful: ['beautiful', 'beautifully']
beautful: ['beautiful', 'beautifully']
beautifulest: ['beautiful-est', 'beautiful est']
beautifull: ['beautifully', 'beautiful']
beggining: ['beginning', 'begging']
behin: ['behind', 'being']
beliars: ['be-liars', 'be liars']
belive: ['believe', 'be-live']
benifit: ['benefit', 'befit']
berriess: ['berries', 'ferries']
bestfriend: ['best-friend', 'best friend']
beuaty: ['beauty', 'beat']
bieber: ['briber', 'bier']
bilbies: ['billies', 'bilges']
bilby: ['billy', 'bib']
birchbark: ['birch-bark', 'birch bark']
bitsey: ['bitsy', 'bits']
blaket: ['blanket', 'bleakest']
boogy: ['biology', 'boozy']
boogying: ['bogeying', 'boogieing']
bookbag: ['book-bag', 'book bag']
boondocking: ['boon-docking', 'boon docking']
borogoves: ['brogues', "brogue's"]
bottomline: ['bottom-line', 'bottom line']
bouney: ['bounty', 'bouncy']
bowhead: ['bow-head', 'bow head']
bowtie: ['bow-tie', 'bow tie']
boyss: ['boys', 'boss']
brachycephalic: []
braedon: ['brae-don', 'brae don']
brezze: ['breeze', 'prezzie']
brids: ['brides', 'braids']
brillig: ['brill', 'broiling']
brocolli: ['broccoli', "broccoli's"]
bronzer: ['bronze', 'bonzer']
brusha: ['brush', 'rush']
buckin: ['bucking', 'buck-in']
buffalos: ['buffaloes', "buffalo's"]
buhbuhbuh: []
buring: ['burying', 'burring']
buterfly: ['butterfly', "butterfly's"]
buttefly: ['butterfly', 'butte-fly']
bzzzzzz: ['bzzz', 'zzz']
camaro: ['Camaro', 'Camaros']
camaros: ['Camaros', 'cameos']
camoflaged: ['camouflaged', 'camouflage']
candleholder: ['candle-holder', 'candle holder']
cantaret: ['cantata', 'cantered']
cantelope: ['cant-elope', 'cant elope']
caporia: ['capo', 'corpora']
casita: ['castra', 'cast']
catagory: ['category', "category's"]
catepillar: ['caterpillar', 'caterpillars']
caveboy: ['cave-boy', 'cave boy']
cev: ['rev', 'Rev']
chappatis: ['chapatis', 'chapattis']
chaws: ['haws', 'chaw']
chchchch: ['cha-cha-cha']
chear: ['ch-ear', 'ch ear']
cheif: ['chef', 'chief']
cherrys: ["cherry's", 'cherry']
childeren: ['children', "children's"]
chillin: ['chilling', 'chill-in']
christinebarton: ['christened', 'christening']
chuga: ['chugga', 'chug']
cibum: ['bum', 'cilium']
climing: ['climbing', 'claiming']
clipity: ['clit', 'clip']
cocoo: ['cocoon', 'co-coo']
colorflies: ['color-flies', 'color flies']
comin: ['coming', 'com-in']
comming: ['coming', 'commuting']
competetion: ['competition', 'competitions']
compititons: ['competitions', "competition's"]
compresserunt: ['compressed', 'compressing']
comtainer: ['container', 'combiner']
concious: ['conscious', 'consciously']
conscendit: ['consent', 'consents']
cooool: ['cool', 'cools']
coooool: ['cool', 'cools']
coooooold: ['cooled', 'cool']
coquo: ['co-quo', 'co quo']
coquus: ['coups', 'conquers']
cosmestic: ['cosmetic', 'cosmetics']
cottenfield: ['cornfield', 'downfield']
coulnd't: ["couldn't", 'counted']
cowfish: ['cow-fish', 'cow fish']
crede: ['cred', 'scree']
crittercams: ['critter-cams', 'critter cams']
cryed: ['cry-ed', 'cry ed']
csep: ['seep', 'cusp']
ctor: ['ct-or', 'ct or']
cuag: ['scag', 'crag']
cuddley: ['cuddly', 'cuddle']
cuh: ['uh', 'cu']
currers: ['curers', 'curries']
currerunt: ['current', 'recurrent']
daVinci: ['dance', 'Vinca']
darent: ['parent', "aren't"]
daugther: ['daughter', 'doughier']
deadmau: ['dead', 'dream']
decepticons: ['deceptions', "deception's"]
decmber: ['December', 'dumber']
decomposers: ['decompose-rs', 'decompose rs']
delish: ['deli-sh', 'deli sh']
denique: ['unique', 'denude']
deoderant: ['deodorant', 'deodorants']
dessicated: ['desiccated', 'desiccate']
dicunt: ['discount', 'dint']
did't: ["didn't", 'didst']
differant: ['differ-ant', 'differ ant']
diffrent: ['different', 'diff-rent']
dificult: ['difficult', 'difficulty']
diiner: ['diviner', 'diner']
dinosuar: ['dinosaur', 'dinosaurs']
dirtbike: ['dirt-bike', 'dirt bike']
discoverd: ['discovered', 'discover']
diserve: ['deserve', 'serve']
displine: ['discipline', 'spline']
dollers: ['doller', 'rollers']
donut: ['donuts', 'do-nut']
doot: ['dot', 'toot']
drlving: ['driving', 'delving']
drumer: ['drummer', 'drum-er']
duckity: ['ducky', 'duckiest']
dugongs: ['dugong', 'gongs']
duirng: ['during', 'dung']
dutchund: ['dachshund', 'thunder']
echidnas: ['echidna', 'Echidna']
eeaw: ['yee-haw', 'hee-haw']
eeaways: ['seaways', "seaway's"]
eeee: ['Deedee', 'tee-hee']
eeeeeeeeeeeh: []
eeek: ['eek', 'week']
eewww: []
egiten: ['eaten', 'eighteen']
eigth: ['eighth', 'neigh']
electrcity: ['electricity', "electricity's"]
elepants: ['elephants', "elephant's"]
eliphant: ['elephant', 'elephants']
elkarbanatzen: []
elkhorns: ['elk-horns', 'elk horns']
elysa: ['Alyssa', 'else']
embarassed: ['embarrassed', 'unembarrassed']
emerent: ['emergent', 'efferent']
emiunt: ['mint', 'emit']
erant: ['errant', 'er-ant']
eret: ['erect', 'egret']
errupt: ['erupt', 'irrupt']
espeshally: ['especially', 'specially']
eum: ['um', 'em']
everyones: ["everyone's", 'every-ones']
exactley: ['exactly', 'inexactly']
exspectat: ['expectant', 'expectorate']
extraterestrial: ['extraterrestrial', 'extraterrestrials']
fFly: ['fly', 'flay']
faddle: ['addle', 'waddle']
famly: ['family', 'foamy']
famouse: ['fa-mouse', 'fa mouse']
farmville: ['familial', 'Danville']
fauvorite: ['favorite', 'favourite']
favortie: ['favor-tie', 'favor tie']
favourtie: ['favour-tie', 'favour tie']
feedle: ['needle', 'feeler']
feeeling: ['feeling', 'feelings']
feelin: ['feeling', 'feel-in']
fffa: ['ff-fa', 'ff fa']
fiddleheads: ['fiddle-heads', 'fiddle heads']
finnaly: ['finally', 'finny']
firewands: ['fire-wands', 'fire wands']
fiying: ['frying', 'flying']
fleese: ['flees', 'fleets']
flighted: ['flight-ed', 'flight ed']
flys: ["fly's", 'flays']
foolbird: ['fool-bird', 'fool bird']
frabjous: ['firebugs', 'frogs']
freezzzzzzing: ['freezing', 'refreezing']
freinds: ['friends', 'rinds']
frends: ['friends', 'fr-ends']
frinds: ['friends', 'rinds']
frisbees: ["Frisbee's", 'Frisbee']
friuts: ['fruits', 'ruts']
froggie: ['foggier', 'groggier']
frumious: ['rumours', 'furious']
fuh: ['uh', 'flush']
fulness: ['fullness', 'foulness']
furrysome: ['furry-some', 'furry some']
futbol: ['futile', 'fumble']
gaint: ['gait', 'gain']
galiant: ['gallivant', 'valiant']
gallos: ['gallows', 'gallops']
gamedays: ['game-days', 'game days']
gauzak: ['muzak', 'gauzy']
generious: ['generous', 'generously']
gimble: ['nimble', 'gamble']
gnar: ['gnarl', 'gar']
gnawin: ['gnawing', 'gnaw-in']
goannas: ['goanna', 'gonna']
godlizard: ['god-lizard', 'god lizard']
graffitti: ['graffiti', 'graffito']
gramdpa: ['grandpa', 'gramma']
grampa: ['gram-pa', 'gram pa']
grandkids: ['grand-kids', 'grand kids']
gril: ['grill', 'grail']
gromer: ['groomer', 'groomers']
groovin: ['grooving', 'groin']
grrrr: ['grr', 'error']
gruyere: ['Gruyere', 'Gruyeres']
gummi: ['gum-mi', 'gum mi']
gummie: ['gummier', 'gummed']
gutairsts: ['guitarists', "guitarist's"]
hagis: ['haggis', 'hag-is']
halfpipe: ['half-pipe', 'half pipe']
haning: ['hanging', 'handing']
happpy: ['happy', 'chappy']
harboiled: ['parboiled', 'reboiled']
heards: ['herds', 'hears']
heev: ['hee', 'whee']
helicoptors: ['helicopters', "helicopter's"]
hersheys: ["Hershey's", 'Hershey']
hhhh: ['shhh', 'Shhh']
hidehout: ['hideout', 'headhunt']
hillarious: ['hilarious', 'hilariously']
hinc: ['inc', 'hic']
hoding: ['hording', 'hooding']
homerun: ['home-run', 'home run']
homeruns: ['home-runs', 'home runs']
hooooooooooot: []
hooooot: ['hoodoo', 'hoot']
hotdog: ['hot-dog', 'hot dog']
hotdogs: ['hot-dogs', 'hot dogs']
howlll: ['howl-ll', 'howl ll']
howllll: ['howl', 'howls']
htm: ['ht', 'hum']
html: ['ht-ml', 'ht ml']
http: ['ht', 'hp']
huc: ['hut', 'hum']
hucque: ['tuque', 'hue']
humongously: ['humongous', 'harmoniously']
hunrgy: ['hungry', 'hung']
i'm: ['vim', 'sim']
iDawg: ['Dagg', 'miaow']
iPods: ["iPod's", 'iPod']
ikasten: ['astern', 'eastern']
indes: ['indies', 'ind-es']
influencial: ['influential', 'influentially']
ingedients: ['ingredients', "ingredient's"]
initals: ['initials', "initial's"]
inlude: ['include', 'interlude']
insturment: ['instrument', 'interment']
inukshuks: []
iphone: ['phone', 'siphon']
ipod: ['pod', 'iPod']
irteerak: ['iterate', 'steerage']
isset: ['is-set', 'is set']
itouch: ['it-ouch', 'it ouch']
itsef: ['itself', 'its']
itsy: ['ditsy', 'bitsy']
jammies: ['jammiest', 'mammies']
jammin: ['jamming', 'jam-min']
jawas: ['jaw-as', 'jaw as']
jewelery: ['jewellery', 'jewelry']
joelmabus: ['Columbus', "Columbus's"]
juddle: ['puddle', 'muddle']
julip: ['tulip', 'julep']
jumparoo: ['jumper', 'Amparo']
junebug: ['jitterbug', 'junkie']
junoir: ['junior', 'junkier']
kawg: ['kw', 'kg']
kayaker: ['kayak-er', 'kayak er']
keepin: ['keeping', 'keep-in']
kernals: ['kernels', "kernel's"]
kindy: ['kindly', 'kind']
kinz: ['kin', 'kink']
klompen: ['lumpen', 'clomped']
kniting: ['knitting', 'kiting']
konfusing: ['confusing', 'infusing']
koosh: ['ooh', 'whoosh']
lacramavisset: ['Clarisse', 'creamiest']
lagunen: ['lacunae', 'linguine']
lalaloopsies: ['Lalaloopsy', 'lapses']
lamborghinis: ["Lamborghini's", 'Lamborghini']
lambroghini: ['Lamborghini', "Lamborghini's"]
lanters: ['planters', 'lanterns']
lappy: ['flappy', 'Slappy']
largst: ['largest', 'largos']
latinum: ['platinum', 'laudanum']
latkes: ['lakes', 'lattes']
lavae: ['lavage', 'larvae']
leapord: ['lapboard', 'leaper']
lect: ['elect', 'let']
leej: ['lee', 'lees']
leggos: ['legs', 'egos']
legos: ['legs', 'egos']
leprachaun: ['leprechaun', 'leprechauns']
lightsabers: ['light-sabers', 'light sabers']
lightyear: ['light-year', 'light year']
lipgloss: ['lip-gloss', 'lip gloss']
listenning: ['listening', 'glistening']
lizzard: ['blizzard', 'lizard']
lizzards: ['blizzards', 'lizards']
logest: ['longest', 'logiest']
longboad: ['longboard', 'longboat']
longboards: ['long-boards', 'long boards']
lookin: ['looking', 'look-in']
looong: ['loon', 'long']
looooooves: ['loopholes', 'loveys']
loopsies: ['loopiest', 'looses']
lorikeet: ['locket', 'rickety']
lowriders: ['low-riders', 'low riders']
luddle: ['puddle', 'muddle']
maaa: ['mama', 'macarena']
maccaroons: ['macaroons', "macaroon's"]
maccherone: ['maccarone', 'macron']
magezines: ['mage-zines', 'mage zines']
magizine: ['magi-zine', 'magi zine']
makazin: ['magazine', 'making']
manxome: ['mangoes', 'maxim']
marshmellows: ['marsh-mellows', 'marsh mellows']
martinlutherkingjr: []
mccellon: ['miscellany', 'Archelon']
mcsteamy: ['stamp']
mealie: ['mealier', 'measlier']
meee: ['melee', 'mete']
meling: ['mewling', 'melting']
mentirisset: ['centrist', 'mentalist']
metamorphasis: ['metamorphosis', "metamorphosis's"]
militibus: ['milites', 'militarise']
mixs: ['mixes', "mix's"]
mmmmm: ['mmm']
mmmmmm: ['mmm']
mmmmmmm: ['mmm']
monkeybread: ['monkey-bread', 'monkey bread']
monotremes: ['monotreme', 'monochromes']
mooooo: ['moo', 'yoo-hoo']
mooooooooore: []
moterbikes: ['motorbikes', "motorbike's"]
motorcross: ['motor-cross', 'motor cross']
motorcylce: ['motorcycle', 'motorcycles']
motorcyle: ['motorcycle', 'motocycle']
moutains: ['mountains', "mountain's"]
mpossible: ['impossible', 'possible']
muaj: ['muzak', 'mu']
mudding: ['muddying', 'muddling']
musturd: ['mus-turd', 'mus turd']
mutil: ['mu-til', 'mu til']
mvp: ['mp', 'mop']
naranjilla: ['Barranquilla', 'granadilla']
natoinal: ['national', 'atonal']
navem: ['nave', 'naves']
ndez: ['Mendez', 'nude']
nebulas: ["nebula's", 'nebula']
neska: ['ska', 'eskola']
niaj: ['ninja', 'naiad']
nickhames: ['nicknames', "nickname's"]
ninjago: ['ninja-go', 'ninja go']
nkauj: ['kanji']
nniue: ['Annie', 'tinnie']
nnnnn: []
nows: ['snows', "now's"]
ntaj: ['natal', 'nanta']
ntiaj: ['Pontiac', 'Santiago']
ntsug: ['tsum', 'nuts']
ntxhais: ['taxis', 'kantharos']
nutsy: ['nuts', 'nutty']
nyob: ['yob', 'nob']
octupus: ['octopus', 'cutups']
oina: ['oink', 'Tina']
oing: ['toing', 'owing']
omnis: ['omnibus', 'omits']
oooooooo: []
ooooot: ['voodoo', 'hoodoo']
optimis: ['optimist', 'optimism']
optmis: ['optimist', 'optimism']
optmus: ['optimus', 'opt-mus']
orcas: ['orc-as', 'orc as']
oustide: ['outside', 'outsider']
outgrabe: ['outgrew', 'outgrow']
outling: ['outlying', 'out-ling']
oxigen: ['oxygen', 'oxen']
pab: ['pa', 'ab']
paddlewheel: ['paddle-wheel', 'paddle wheel']
padewan: ['Kaden', 'pawing']
paj: ['pa', 'pay']
pandekager: ['poundage', 'Xander']
papiolionis: ['pavilions', "pavilion's"]
paralympic: ['Paralympic', 'Paralympics']
partys: ["party's", 'party']
patroling: ['patrolling', 'paroling']
pavaret: ['havarti', 'paved']
peacful: ['peaceful', 'peacefully']
pecuniam: ['pecuniary', 'pecan']
pecunium: ['plenum', 'pecuniary']
perfoming: ['performing', 'perfuming']
permisson: ['permission', 'prison']
phane: ['pane', 'thane']
pharoah: ['pharaoh', 'pharaohs']
phyed: ['payed', 'hayed']
picturs: ['pictures', "picture's"]
pierogies: ["pirogi's", 'pirogi']
piggie: ['piggies', 'piggier']
pinchbug: ['pinch-bug', 'pinch bug']
pinecone: ['pine-cone', 'pine cone']
pizzaaaaaaa: ['pizza']
placemats: ['place-mats', 'place mats']
plaese: ['please', 'plates']
planetmercury: ['planet-mercury', 'planet mercury']
planetvenus: ['platens', 'planets']
playdough: ['play-dough', 'play dough']
plee: ['plebe', 'pee']
plueret: ['plunder', 'plummet']
poeple: ['popple', 'people']
poofy: ['poof', 'spoof']
popsicles: ['popsicle', "Popsicle's"]
postquam: ['postage', 'postmark']
potstickers: ['pots-tickers', 'pots tickers']
poult: ['pout', 'poultry']
pourer: ['pour-er', 'pour er']
pov: ['prov', 'pox']
praemium: ['premium', 'premiums']
praestigiator: ['prestigious', 'prestige']
precent: ['recent', 'prescient']
ptptptpt: ['putt-putt']
puag: ['pug', 'pupa']
puddding: ['pud-dding', 'pud dding']
puddy: ['ruddy', 'pudgy']
pudmuddle: ['pud-muddle', 'pud muddle']
puella: ['paella', 'Luella']
puellam: ['ullam', 'paella']
puggles: ['puggle', 'muggles']
pumkin: ['pumpkin', 'puking']
pupas: ["pupa's", 'pup-as']
puppys: ["puppy's", 'puppy']
pushups: ['push-ups', 'push ups']
qestion: ['question', 'questions']
qhov: ['hove']
quaesiuunt: ['quaint', 'quiescent']
quantus: ["quantum's", 'quantum']
quav: ['qua', 'quaver']
quinceanera: []
quolls: ['quoll', 'quills']
raccoons: ["raccoon's", 'raccoon']
racecars: ['race-cars', 'race cars']
racoons: ['racoon', "raccoon's"]
racooon: ['racoon', 'raccoon']
ramyeon: ['rayon', 'ramekin']
raquet: ['racquet', 'racquets']
raths: ['rats', 'wreaths']
realaxing: ['real-axing', 'real axing']
recomended: ['recommended', 'recommenced']
recylcing: ['recycling', 'replacing']
recyling: ['recycling', 'restyling']
reeses: ['reverses', 'releases']
reginae: ['Reginae', 'regional']
remainig: ['remaining', 'remaking']
rememberance: ['remembrance', 'remembrances']
remenber: ['remember', 'renumber']
reprehendere: ['reprehend-ere', 'reprehend ere']
rhinocerus: ['rhinoceros', 'rhinoceroses']
roading: ['reloading', 'trading']
rockin: ['rocking', 'rock-in']
rockstar: ['rocks-tar', 'rocks tar']
rogare: ['roarer', 'roar']
rogavi: ['regain', 'Brolga']
rollercoasters: ['roller-coasters', 'roller coasters']
rootworm: ['root-worm', 'root worm']
rotobeater: ['rotated', 'roadster']
roundin: ['rounding', 'round-in']
runing: ['running', 'ruining']
s'mores: ['sores', 'mores']
sacci: ['sac', 'saki']
sandwhich: ['sand-which', 'sand which']
sanpans: ['sampans', 'spans']
saurapods: ['sauropods', "sauropod's"]
scarey: ['scary', 'scare']
scire: ['sci-re', 'sci re']
scuppernog: ['spiderling', 'scootering']
senstive: ['sensitive', 'sensitives']
sextillion: ['sexton', 'extolling']
shaps: ['sharps', 'shapes']
sharpkon: ['sharpen', 'sharping']
sheltars: ['shelters', "shelter's"]
shhhh: ['shhh', 'shh']
shhhhhh: ['shhh', 'shh']
sidewalker: ['sidewalk-er', 'sidewalk er']
sily: ['silty', 'silly']
singity: ['salinity', 'stingy']
siv: ['spiv', 'shiv']
sizse: ['size', 'sizes']
skidoos: ['skids', "skid's"]
skiiers: ['skiers', 'skivers']
slammin: ['slamming', 'slam-min']
sleepity: ['sleepily', 'sleety']
slinkies: ['slinkiest', 'slinkier']
slithy: ['slithery', 'smithy']
slurpy: ['slurp', 'slurry']
slushies: ['slushiest', 'slushiness']
smartboard: ['smart-board', 'smart board']
smokin: ['smoking', 'smocking']
smores: ['sores', 'mores']
snazy: ['snazzy', 'snaky']
snorkles: ['snorkelers', 'snorkels']
snowboader: ['snowboarder', 'snowboarders']
snowborder: ['snowboarder', 'snow-border']
snowdog: ['snow-dog', 'snow dog']
snowmobiler: ['snowmobile', 'snowmobiles']
snowmonster: ['snow-monster', 'snow monster']
snowwwwwwwmobilinggg: ['snowmobiling']
snuggly: ['snugly', 'snuggle']
socceroos: ["soccer's", 'scherzos']
solarviews: ['solar-views', 'solar views']
soondaechon: ['stanchion', 'snatching']
soooo: ['yoo-hoo', 'woooosh']
sooooo: ['yoo-hoo', 'woooosh']
soooooooooooooooo: []
sored: ['stored', 'spored']
souviens: ['souvenirs', 'soviets']
spash: ['splash', 'spa-sh']
spicey: ['spicy', 'spice']
spiderlings: ['spider-lings', 'spider lings']
splosion: ['sploshing', 'sloshing']
squeazed: ['squeezed', 'squealed']
ssshhhh: ['shhh', 'sss']
sssss: ['ssss', 'Sssssss']
ssssss: ['Sssssss', 'ssss']
staghorns: ['stag-horns', 'stag horns']
standin: ['standing', 'stand-in']
stareded: ['stared-ed', 'stared ed']
stealthly: ['stealthily', 'stealthy']
stndaing: ['standing', 'stranding']
streeetch: ['stretch', 'stretchy']
strek: ['streak', 'trek']
stuffies: ['stuffiest', 'stuffiness']
sua: ['skua', 'sup']
sucky: ['suck', 'yucky']
summersalts: ['summers-alts', 'summers alts']
summmer: ['summer', 'summery']
sunglass: ['sung-lass', 'sung lass']
sunprints: ['sun-prints', 'sun prints']
surpise: ['surprise', 'surmise']
surriunded: ['surrounded', 'surround']
surrouned: ['surrounded', 'surround']
swiming: ['swimming', 'swiping']
swimity: ['swimsuit', 'swim']
tabellam: ['tabla', 'Izabella']
tagine: ['tagline', 'tine']
taldeka: ['talk', 'tilde']
tarheelreader: ['Starchaser', 'steeler']
tatoo: ['tattoo', 'ta-too']
tator: ['tat-or', 'tat or']
teb: ['tb', 'web']
teleporting: ['teleport', 'teleportation']
temptant: ['tempt-ant', 'tempt ant']
tenticles: ['testicles', 'tentacles']
thauj: ['haj', 'thus']
thiaj: ['haj', 'this']
throated: ['throat-ed', 'throat ed']
toliet: ['toilet', 'tole']
toooooot: ['toot', 'toots']
toooooty: ['toothy', 'toot']
torti: ['tor-ti', 'tor ti']
tounge: ['tongue', 'tonged']
tounges: ['tongues', 'lounges']
toves: ['troves', 'stoves']
trackable: ['track-able', 'track able']
trampoliner: ['trampoline', 'trampolines']
tream: ['stream', 'tram']
treaters: ['tr-eaters', 'tr eaters']
triped: ['tripped', 'tripled']
tsetter: ['setter', 'tsetse']
tsheb: ['tushes', 'tush']
tulgey: ['tulle', 'bulgy']
tunning: ['stunning', 'tuning']
turken: ['turkey', 'tureen']
turkoise: ['turquoise', 'turquoises']
turnity: ['trinity', 'unity']
txhua: ['thud', 'thunk']
txhuag: ['textual', 'tugs']
txob: ['throb', 'taxon']
uffish: ['offish', 'fish']
ug: ['ugh', 'tug']
ugli: ['uglier', 'ugly']
ultrathon: ['adulteration', 'ultrasound']
ummm: ['um-mm', 'um mm']
uncomforatable: ['uncomfortable', 'uncomfortably']
ungreased: ['ungraded', 'unpressed']
unicyclists: ['uni-cyclists', 'uni cyclists']
unteach: ['unleash', 'unlatch']
utiful: ['dutiful', 'gutful']
utk: ['yut', 'yuk']
valuble: ['valuable', 'valuables']
veeeery: ['veneer', 'very']
victrola: ['Victrola', 'vitriol']
vident: ['vi-dent', 'vi dent']
videogames: ['video-games', 'video games']
villians: ['villi-ans', 'villi ans']
voavanga: []
volleiballl: ['volleyball', 'volleyballs']
vorpal: ['opal', 'vworp']
vult: ['vault', 'ult']
wabe: ['warble', 'wave']
wackers: ['whackers', 'wacker']
wacthed: ['watched', 'withed']
waer: ['waver', 'water']
waffes: ['waffles', 'wafflers']
wakeboarders: ['wake-boarders', 'wake boarders']
walkity: ['walk', 'walkway']
waterpark: ['water-park', 'water park']
waterpolo: ['water-polo', 'water polo']
waterslide: ['water-slide', 'water slide']
waterspots: ['waterspouts', 'waters-pots']
whatcha: ['watch', 'hatch']
wheeeeee: ['wheeze', 'wheelie']
wheeelchairs: ['wheelchairs', "wheelchair's"]
whyyyyyy: []
windchimes: ['wind-chimes', 'wind chimes']
windsheild: ['windshield', 'windshields']
wolfspider: ['wolf-spider', 'wolf spider']
wondeering: ['wondering', 'wonderingly']
wooly: ['woolly', 'wool']
woon: ['swoon', 'woo']
wouldO: ['would', 'woulds']
woulday: ['would', 'woulds']
wouldodge: ['would', "would've"]
wouldreka: ['would', "would've"]
wrestlemania: ['wrestle-mania', 'wrestle mania']
wuzzy: ['muzzy', 'fuzzy']
www: ['wow', 'Eww']
xanthan: ['Nathan', 'xanthidae']
xanthic: ['xanthidae', 'synthetic']
xaxis: ['axis', 'taxis']
xigua: ['Riga', 'taiga']
yeej: ['ye', 'Lychee']
yejin: ['yin', 'yen']
yooks: ['yonks', 'yolks']
yoyo: ['yo-yo', 'yo yo']
yoyos: ['yos', 'yobbos']
yuav: ['yuan', 'ya']
yumm: ['yummy', 'yum']
zazzer: ['jazzier', 'pzazz']
zipline: ['zip-line', 'zip line']
zooks: ['zoo-ks', 'zoo ks']
zuccchini: ['zucchini']
zuchini: ['zucchini', 'urchin']
zuzz: ['fuzz', 'buzz']
zza: ['pizza', 'zzz']
zzzzzz: ['zzz', 'bzzz']
zzzzzzzzzzzzzzzzzzzzzzzzzzz: []
